 ###########
 #     ##  #
 #   o   o #
#### ## oo #
#   o #    #
# ooo # ####
#   # # o ##
#  #  #  o #
# o# o#    #
#   ..# ####
####.. o #@#
#.....# o# #
##....#  o #
 ##..##    #
  ##########
