             ######
 #############....#
##   ##     ##....#
#  oo##  o @##....#
#      oo o#  ....#
#  o ## oo # # ...#
#  o ## o  #  ....#
## ##### ### ##.###
##   o  o ##   .  #
# o###  # ##### ###
#   o   #       #
#  o #o o o###  #
# ooo# o   # ####
#    #  oo #
######   ###
     #####
